4 4 4 4 4 4 4 4 4 4 4 4 4 4 4 4 4 4 4 4 4 4 4 4 4
3 0 0 0 0 0 0 0 0 0 0 0 0 0 0 0 0 0 0 0 0 0 0 0 3
3 0 0 0 0 0 0 6 0 0 0 0 0 0 0 0 0 0 0 0 0 0 0 0 3
3 0 0 0 0 0 0 6 0 0 0 2 2 2 2 2 2 0 0 0 6 6 0 0 2
3 0 0 0 0 0 0 6 0 0 0 0 0 0 0 0 0 0 0 0 6 6 0 0 2
3 0 0 0 0 0 0 6 0 0 0 0 0 0 0 0 0 0 0 0 0 0 0 0 2
3 0 0 0 6 6 6 6 0 2 1 6 0 6 1 2 0 0 0 0 0 0 0 0 3
2 0 0 0 6 0 0 5 0 2 1 6 0 6 1 2 0 0 0 5 0 0 0 0 3
2 0 0 5 6 0 0 0 0 2 1 0 0 0 1 2 0 0 0 0 0 0 0 0 3
2 0 0 0 6 0 0 0 0 2 1 7 5 8 1 2 0 0 0 0 0 0 0 0 3
2 0 0 0 6 6 6 6 0 2 1 0 5 0 1 2 0 6 6 6 6 0 0 0 3
3 0 0 0 0 0 0 0 0 2 1 0 0 0 1 2 0 0 0 0 6 5 0 0 2
3 0 0 0 0 0 0 0 0 2 1 6 0 6 1 2 0 0 0 0 6 0 0 0 2
3 0 0 0 0 5 0 0 0 2 1 6 0 6 1 2 0 5 0 0 6 0 0 0 3
3 0 0 0 0 0 0 0 0 0 0 0 0 0 0 0 0 6 6 6 6 0 0 0 3
3 0 0 6 6 0 0 0 0 0 0 0 0 0 0 0 0 6 0 0 0 0 0 0 3
3 0 0 6 6 0 0 0 2 2 2 2 2 2 0 0 0 6 0 0 0 0 0 0 3
3 0 0 0 0 0 0 0 0 0 0 0 0 0 0 0 0 6 0 0 0 0 0 0 3
3 0 0 0 0 0 0 0 0 0 0 0 0 0 0 0 0 0 0 0 0 0 0 0 3
4 4 4 4 4 4 4 4 4 4 4 4 4 4 4 4 4 4 4 4 4 4 4 4 4

