6 6 6 6 6 6 6 6 6 6 6 6 6 5 5 6 6 6 6 6 6 6 6 6 6
6 0 0 0 0 0 0 0 0 0 0 0 0 0 0 0 0 0 6 0 0 0 0 0 6
6 0 0 0 6 6 0 6 6 6 0 0 6 0 0 0 0 0 6 0 0 0 0 0 6
6 0 0 0 0 0 0 6 0 6 0 0 6 6 6 6 6 0 0 0 0 0 0 0 6
6 0 0 6 0 0 6 6 0 0 0 0 0 0 7 0 6 0 0 0 6 6 6 0 6
6 0 0 6 0 0 6 0 0 0 0 6 6 0 0 0 0 0 0 0 0 6 0 0 6
6 0 0 6 0 0 0 0 0 0 0 0 0 0 0 0 0 0 0 0 0 6 0 0 3
6 6 0 6 6 6 6 0 0 0 0 0 6 6 0 6 6 6 0 0 0 6 0 6 3
0 0 0 6 0 0 6 0 0 6 0 0 6 0 0 0 0 6 0 0 0 6 0 6 6
5 0 0 6 0 0 6 6 6 6 0 0 6 0 0 0 0 6 0 0 0 6 0 0 6
5 0 0 6 0 0 6 0 0 6 0 0 6 6 6 0 0 6 0 0 0 6 0 0 6
6 0 0 6 0 0 6 0 0 6 0 0 0 0 6 0 0 6 0 0 0 6 0 0 3
6 0 0 6 0 0 0 0 0 0 0 0 0 0 6 0 6 6 6 6 0 6 0 0 3
6 0 0 6 0 0 0 0 0 0 0 0 0 0 0 0 0 0 0 0 0 6 0 0 6
6 0 0 6 6 0 0 6 8 0 0 0 0 6 6 0 0 6 0 0 0 6 0 0 6
6 0 6 6 6 0 0 6 0 6 0 0 0 6 0 0 0 6 0 0 0 6 0 0 6
6 0 0 0 0 0 0 6 0 6 0 0 0 6 6 0 0 6 0 0 0 0 0 0 3
6 0 0 0 0 0 0 6 6 6 0 0 0 0 0 0 0 0 0 0 0 0 0 0 3
6 0 0 0 0 0 0 0 0 0 0 0 0 0 0 0 0 0 0 0 6 6 0 0 6
6 6 6 6 6 6 6 6 6 6 6 0 6 6 5 5 6 6 6 6 6 6 6 6 6

